key	icon	parent_group
#ui_unit_groupings_tables;1;db/ui_unit_groupings_tables/!!!!!!!2xunitsize_compat_bodyguards_allinone_en
assassin_bodyguard1	wh2_main_skv_missile_infantry_throwing_star	heroes_agents
assassin_bodyguard2	wh2_main_missile_infantry_sling	heroes_agents
assassin_bodyguard3	wh2_main_infantry_dual_swords	heroes_agents
assassin_bodyguard4	wh2_dlc14_skv_infantry_guandao	heroes_agents
brt_damsel_beasts_bodyguard1	wh_dlc03_lore_beasts	heroes_agents
brt_damsel_beasts_bodyguard2	wh_dlc03_lore_beasts	heroes_agents
brt_damsel_beasts_bodyguard3	wh_dlc03_lore_beasts	heroes_agents
brt_damsel_beasts_bodyguard4	wh_dlc03_lore_beasts	heroes_agents
brt_damsel_heavens_bodyguard1	wh_main_lore_heavens	heroes_agents
brt_damsel_heavens_bodyguard2	wh_main_lore_heavens	heroes_agents
brt_damsel_heavens_bodyguard3	wh_main_lore_heavens	heroes_agents
brt_damsel_heavens_bodyguard4	wh_main_lore_heavens	heroes_agents
brt_damsel_life_bodyguard1	wh_dlc05_wef_lore_life	heroes_agents
brt_damsel_life_bodyguard2	wh_dlc05_wef_lore_life	heroes_agents
brt_damsel_life_bodyguard3	wh_dlc05_wef_lore_life	heroes_agents
brt_damsel_life_bodyguard4	wh_dlc05_wef_lore_life	heroes_agents
brt_henri_le_massif_bodyguard1	wh2_pro08_cha_felix	heroes_agents
brt_henri_le_massif_bodyguard2	cavalry	heroes_agents
brt_henri_le_massif_bodyguard3	shock_cavalry	heroes_agents
brt_henri_le_massif_bodyguard4	wh_main_brt_champion	heroes_agents
brt_paladin_bodyguard1	wh2_pro08_cha_felix	heroes_agents
brt_paladin_bodyguard2	cavalry	heroes_agents
brt_paladin_bodyguard3	shock_cavalry	heroes_agents
brt_paladin_bodyguard4	wh_main_brt_champion	heroes_agents
chd_bull_centaur_taurruk_bodyguard1	wh3_dlc23_chd_bull_centaur_taurruk	heroes_agents
chd_castellan_bodyguard1	infantry_axe	heroes_agents
chd_castellan_bodyguard2	wh3_dlc23_chd_fireglaive	heroes_agents
chd_castellan_war_machine1	wh3_dlc23_chd_iron_daemon	heroes_agents
chd_castellan_war_machine2	wh3_dlc23_chd_dreadquake	heroes_agents
chd_castellan_war_machine3	wh3_dlc23_chd_iron_daemon	heroes_agents
chd_castellan_war_machine4	wh3_dlc23_chd_dreadquake	heroes_agents
chd_daemonsmith_sorcerer_war_machine1	wh3_dlc23_chd_iron_daemon	heroes_agents
chd_overseer_bodyguard1	wh2_pro08_cha_gotrek	commander
chd_overseer_bodyguard2	wh3_dlc23_chd_blunderbuss_axe	commander
chd_overseer_war_machine1	wh3_dlc23_chd_iron_daemon	commander
chd_overseer_war_machine2	wh3_dlc23_chd_dreadquake	commander
chd_overseer_war_machine3	wh3_dlc23_chd_dreadquake	commander
chd_overseer_war_machine4	wh3_dlc23_chd_iron_daemon	commander
chd_overseer_war_machine5	wh3_dlc23_chd_dreadquake	commander
chd_sorcerer_prophet_bodyguard1	wh3_dlc23_infantry_axe_magical	commander
chd_sorcerer_prophet_bodyguard2	dwf_irondrakes_torpedo	commander
chd_zhatan_war_machine1	wh3_dlc23_chd_skullcracker	commander
chieftain_bodyguard1	infantry_sword	heroes_agents
chieftain_bodyguard2	infantry_spear	heroes_agents
chieftain_bodyguard3	wh2_main_skv_infantry_sword_stormvermin	heroes_agents
chieftain_bodyguard4	wh2_main_skv_infantry_halberd	heroes_agents
cst_damned_paladin_bodyguard1	wh_main_brt_champion	heroes_agents
cst_damned_paladin_bodyguard2	wh_main_brt_champion	heroes_agents
cst_gunnery_wight_bodyguard1	wh2_dlc11_cst_gunnery_wight	heroes_agents
cst_gunnery_wight_bodyguard2	wh2_dlc11_cst_gunnery_wight	heroes_agents
cst_gunnery_wight_bodyguard3	wh2_dlc11_cst_gunnery_wight	heroes_agents
cst_gunnery_wight_bodyguard4	wh2_dlc11_cst_gunnery_wight	heroes_agents
cst_gunnery_wight_bodyguard5	wh2_dlc11_cst_gunnery_wight	heroes_agents
cst_mourngul_haunter_bodyguard1	wh2_dlc11_cst_mourngul_haunter	heroes_agents
cst_vampire_fleet_admiral_death_bodyguard1	wh_main_lore_death	commander
cst_vampire_fleet_admiral_death_bodyguard2	wh_main_lore_death	commander
cst_vampire_fleet_admiral_death_bodyguard3	wh_main_lore_death	commander
cst_vampire_fleet_admiral_deeps_bodyguard1	wh2_dlc11_cst_lore_deeps	commander
cst_vampire_fleet_admiral_deeps_bodyguard2	wh2_dlc11_cst_lore_deeps	commander
cst_vampire_fleet_admiral_deeps_bodyguard3	wh2_dlc11_cst_lore_deeps	commander
cst_vampire_fleet_admiral_vampires_bodyguard1	wh_main_lore_vampires	commander
cst_vampire_fleet_admiral_vampires_bodyguard2	wh_main_lore_vampires	commander
cst_vampire_fleet_admiral_vampires_bodyguard3	wh_main_lore_vampires	commander
cst_vampire_fleet_captain_death_bodyguard1	wh_main_lore_death	heroes_agents
cst_vampire_fleet_captain_death_bodyguard2	wh_main_lore_death	heroes_agents
cst_vampire_fleet_captain_deeps_bodyguard1	wh2_dlc11_cst_lore_deeps	heroes_agents
cst_vampire_fleet_captain_deeps_bodyguard2	wh2_dlc11_cst_lore_deeps	heroes_agents
cst_vampire_fleet_captain_vampires_bodyguard1	wh_main_lore_vampires	heroes_agents
cst_vampire_fleet_captain_vampires_bodyguard2	wh_main_lore_vampires	heroes_agents
cth_alchemist_bodyguard1	infantry_sword	heroes_agents
cth_alchemist_bodyguard2	wh2_dlc11_cst_close_quarters_missile_infantry	heroes_agents
cth_alchemist_bodyguard3	missile_infantry_rifle	heroes_agents
cth_alchemist_bodyguard4	wh2_dlc11_cst_specialist_missile_infantry	heroes_agents
cth_alchemist_bodyguard5	wh2_dlc11_cst_specialist_missile_infantry	heroes_agents
cth_alchemist_bodyguard6	dwf_irondrakes_torpedo	heroes_agents
cth_alchemist_mount1	wh3_cth_balloon	heroes_agents
cth_alchemist_mount2	wh3_cth_balloon	heroes_agents
cth_alchemist_mount3	wh3_cth_balloon	heroes_agents
cth_astromancer_bodyguard1	infantry_spear	heroes_agents
cth_astromancer_bodyguard2	missile_infantry_bow	heroes_agents
cth_astromancer_bodyguard3	infantry_sword	heroes_agents
cth_astromancer_bodyguard4	missile_infantry_bow	heroes_agents
cth_astromancer_bodyguard5	wh3_cth_terracotta_sentinel	heroes_agents
cth_astromancer_mount1	wh3_dlc24_veh_zhangu_war_drum	heroes_agents
cth_astromancer_mount2	magic_chariot	heroes_agents
cth_gate_master_bodyguard1	wh3_dlc24_cth_gate_master	heroes_agents
cth_gate_master_bodyguard2	wh3_dlc24_cth_gate_master	heroes_agents
cth_gate_master_mount1	wh3_dlc24_veh_zhangu_war_drum	heroes_agents
cth_magistrate_bodyguard_yang_1	infantry_sword	commander
cth_magistrate_bodyguard_yang_2	infantry_spear_halberd	commander
cth_magistrate_bodyguard_yang_3	infantry_spear	commander
cth_magistrate_bodyguard_yang_4	wh2_dlc14_skv_infantry_guandao	commander
cth_magistrate_bodyguard_yang_5	infantry_sword_great	commander
cth_magistrate_bodyguard_yang_6	shock_cavalry	commander
cth_magistrate_bodyguard_yang_7	cavalry	commander
cth_magistrate_bodyguard_yin_1	missile_infantry_bow	commander
cth_magistrate_bodyguard_yin_2	missile_infantry_bow	commander
cth_magistrate_bodyguard_yin_3	wh2_main_hef_missile_infantry_bow_spear	commander
cth_magistrate_bodyguard_yin_4	wh3_ksl_bow_glaive_infantry	commander
cth_magistrate_bodyguard_yin_5	wh2_main_def_missile_infantry_bow_shades_great_weapons	commander
cth_magistrate_bodyguard_yin_6	missile_infantry_rifle	commander
cth_magistrate_bodyguard_yin_7	wh2_dlc11_cst_close_quarters_missile_infantry	commander
cth_magistrate_bodyguard_yin_8	cavalry	commander
cth_magistrate_mount1	wh3_cth_balloon	commander
cth_magistrate_mount2	wh3_cth_balloon	commander
cth_magistrate_mount3	chariot	commander
cth_magistrate_mount4	magic_chariot	commander
cth_magistrate_mount5	wh3_dlc24_veh_zhangu_war_drum	commander
cth_shugengan_yang_bodyguard1	infantry_spear	commander
cth_shugengan_yang_bodyguard2	wh2_dlc14_skv_infantry_guandao	commander
cth_shugengan_yang_bodyguard3	missile_infantry_bow	commander
cth_shugengan_yang_bodyguard4	wh2_dlc11_cst_explosives_infantry	commander
cth_shugengan_yang_bodyguard5	shock_cavalry	commander
cth_shugengan_yang_bodyguard6	cavalry_flying	commander
cth_shugengan_yin_bodyguard1	infantry_spear_halberd	commander
cth_shugengan_yin_bodyguard2	infantry_sword	commander
cth_shugengan_yin_bodyguard3	missile_infantry_bow	commander
cth_shugengan_yin_bodyguard4	wh_dlc05_wef_waystalker	commander
cth_shugengan_yin_bodyguard5	cavalry	commander
cth_shugengan_yin_bodyguard6	cavalry_flying	commander
def_death_hag_bodyguard_1	wh2_main_def_dignitary	heroes_agents
def_death_hag_bodyguard_2	wh2_main_def_dignitary	heroes_agents
def_death_hag_bodyguard_3	wh2_main_def_dignitary	heroes_agents
def_dreadlord_bodyguard_1	missile_infantry_bow	commander
def_dreadlord_bodyguard_2	missile_cavalry_bow	commander
def_dreadlord_bodyguard_3	wh2_main_cold_one	commander
def_dreadlord_bodyguard_4	missile_cavalry_bow	commander
def_dreadlord_bodyguard_5	wh2_main_def_missile_infantry_handbow	commander
def_dreadlord_female_bodyguard_1	infantry_sword	commander
def_dreadlord_female_bodyguard_2	shock_cavalry	commander
def_dreadlord_female_bodyguard_3	wh2_main_cold_one	commander
def_dreadlord_female_bodyguard_4	infantry_spear_halberd	commander
def_high_beastmaster_bodyguard_1	infantry_spear	commander
def_high_beastmaster_bodyguard_2	cavalry	commander
def_high_beastmaster_bodyguard_3	wh2_main_cold_one	commander
def_high_beastmaster_bodyguard_4	wh2_dlc17_bst_manticore	commander
def_khainite_assassin_bodyguard_1	wh2_main_def_spy	heroes_agents
def_khainite_assassin_bodyguard_2	wh2_main_def_spy	heroes_agents
def_master_bodyguard_1	wh2_dlc14_def_champion	heroes_agents
def_master_bodyguard_2	wh2_dlc14_def_champion	heroes_agents
def_master_bodyguard_3	wh2_dlc14_def_champion	heroes_agents
def_master_bodyguard_4	wh2_dlc14_def_champion	heroes_agents
dwf_dragon_slayer_bodyguard1	dwf_dragon_slayer	heroes_agents
dwf_dragon_slayer_bodyguard2	dwf_dragon_slayer	heroes_agents
dwf_dragon_slayer_bodyguard3	dwf_dragon_slayer	heroes_agents
dwf_master_engineer_bodyguard1	wh_main_dwf_master_engineer	heroes_agents
dwf_master_engineer_bodyguard2	wh_main_dwf_master_engineer	heroes_agents
dwf_master_engineer_bodyguard3	wh_main_dwf_master_engineer	heroes_agents
dwf_master_engineer_bodyguard4	wh_main_dwf_master_engineer	heroes_agents
dwf_master_engineer_bodyguard5	wh_main_dwf_master_engineer	heroes_agents
dwf_master_engineer_bodyguard6	wh_main_dwf_master_engineer	heroes_agents
dwf_master_engineer_bodyguard7	wh_main_dwf_master_engineer	heroes_agents
dwf_rune_smith_bodyguard2	wh_main_dwf_runesmith	heroes_agents
dwf_rune_smith_bodyguard3	wh_main_dwf_runesmith	heroes_agents
dwf_thane_bodyguard1	wh_main_dwf_champion	heroes_agents
dwf_thane_bodyguard2	wh_main_dwf_champion	heroes_agents
dwf_thane_bodyguard3	wh_main_dwf_champion	heroes_agents
dwf_thane_bodyguard4	wh_main_dwf_champion	heroes_agents
dwf_thane_bodyguard5	wh_main_dwf_champion	heroes_agents
dwf_thane_bodyguard6	wh_main_dwf_champion	heroes_agents
emp_captain_retinue_1	infantry_spear	heroes_agents
emp_captain_retinue_2	infantry_spear_halberd	heroes_agents
emp_captain_retinue_3	cavalry	heroes_agents
emp_captain_retinue_4	infantry_sword_great	heroes_agents
emp_captain_retinue_5	infantry_sword	heroes_agents
emp_captain_retinue_6	cavalry	heroes_agents
emp_captain_retinue_7	shock_cavalry	heroes_agents
emp_captain_retinue_8	cavalry_griffon_halberd	heroes_agents
emp_captain_retinue_9	cavalry_flying	heroes_agents
emp_engineer_mount_1	emp_steam_tank	heroes_agents
emp_engineer_mount_2	emp_marienburg_land_ship	heroes_agents
emp_engineer_retinue_1	missile_infantry_rifle	heroes_agents
emp_engineer_retinue_2	wh2_dlc11_cst_specialist_missile_infantry	heroes_agents
emp_engineer_retinue_3	missile_cavalry_rifle	heroes_agents
emp_engineer_retinue_4	missile_cavalry_grenade_launcher	heroes_agents
emp_general_retinue_1	infantry_sword_great	commander
emp_general_retinue_2	cavalry	commander
emp_general_retinue_3	shock_cavalry	commander
emp_warrior_priest_retinue_1	wh_main_emp_dignitary	heroes_agents
emp_warrior_priest_retinue_2	wh_dlc04_flagellant	heroes_agents
emp_warrior_priest_retinue_3	cavalry	heroes_agents
emp_warrior_priest_retinue_4	empbodyguard_hammer_great_cavalry	heroes_agents
emp_witch_hunter_retinue_1	missile_infantry_bow	heroes_agents
emp_witch_hunter_retinue_2	wh2_dlc11_cst_specialist_missile_infantry	heroes_agents
emp_witch_hunter_retinue_3	missile_infantry_pistol	heroes_agents
emp_witch_hunter_retinue_4	missile_cavalry_pistol	heroes_agents
emp_witch_hunter_retinue_5	missile_cavalry_grenade_launcher	heroes_agents
eshin_sorcerer_bodyguard1	wh2_main_skv_missile_infantry_throwing_star	heroes_agents
eshin_sorcerer_bodyguard2	wh2_main_missile_infantry_sling	heroes_agents
eshin_sorcerer_bodyguard3	wh2_dlc14_skv_infantry_guandao	heroes_agents
grey_seer_plague_bodyguard1	infantry_sword	commander
grey_seer_plague_bodyguard2	wh2_main_skv_infantry_halberd	commander
grey_seer_plague_bodyguard3	wh2_main_lore_plague	commander
grey_seer_ruin_bodyguard1	wh2_main_skv_infantry_sword_stormvermin	commander
grey_seer_ruin_bodyguard2	wh2_main_skv_infantry_halberd	commander
grey_seer_ruin_bodyguard3	wh2_main_lore_ruin	commander
grn_black_orc_big_boss_bodyguard1	wh3_dlc26_grn_inf_black_orcs_shields	heroes_agents
grn_black_orc_big_boss_bodyguard2	infantry_axe_great	heroes_agents
grn_black_orc_big_boss_bodyguard3	infantry_axe_dual	heroes_agents
grn_black_orc_big_boss_bodyguard4	shock_cavalry_boar	heroes_agents
grn_goblin_big_boss_bodyguard1	infantry_spear	heroes_agents
grn_goblin_big_boss_bodyguard2	wh_dlc06_grn_nasty_skulker	heroes_agents
grn_goblin_big_boss_bodyguard3	cavalry_wolf	heroes_agents
grn_goblin_big_boss_bodyguard4	cavalry_spider	heroes_agents
grn_night_goblin_big_boss_bodyguard1	wh3_dlc26_grn_char_night_goblin_big_boss	heroes_agents
grn_night_goblin_big_boss_bodyguard2	wh_dlc06_grn_squig_cavalry	heroes_agents
grn_night_goblin_shaman_bodyguard1	missile_infantry_bow	heroes_agents
grn_night_goblin_shaman_bodyguard2	wh_dlc06_grn_squig_cavalry	heroes_agents
grn_orc_shaman_bodyguard1	wh3_dlc26_grn_infantry_club	heroes_agents
grn_orc_shaman_bodyguard2	wh3_dlc26_grn_cavalry_boar_sword	heroes_agents
grn_orc_shaman_bodyguard3	wh3_dlc26_grn_infantry_club_dual	heroes_agents
grn_orc_shaman_bodyguard4	wh3_dlc26_grn_cavalry_boar_spear	heroes_agents
grn_river_troll_hag_bodyguard1	wh_main_lore_death	heroes_agents
ikit_claw_bodyguard1	wh2_dlc11_cst_specialist_missile_infantry	commander
ikit_claw_bodyguard2	wh2_dlc11_cst_specialist_missile_infantry	commander
ikit_claw_bodyguard3	dwf_irondrakes	commander
ikit_claw_bodyguard4	wh2_dlc14_skv_warp_grinder	commander
ikit_claw_bodyguard5	wh2_dlc14_skv_missile_infantry_poisoned_wind_mortar	commander
ikit_claw_bodyguard6	wh2_main_skv_missile_infantry_globe	commander
ikit_claw_bodyguard7	wh2_main_lore_ruin	commander
ikit_claw_bodyguard8	wh2_main_lore_ruin	commander
ksl_boris_bodyguard1	infantry_sword	commander
ksl_boris_bodyguard2	infantry_sword_great	commander
ksl_boris_bodyguard3	wh2_dlc14_skv_infantry_guandao	commander
ksl_boris_bodyguard4	shock_cavalry	commander
ksl_boris_bodyguard5	wh3_bear_cavalry	commander
ksl_boyar_bodyguard1	wh3_ksl_pistol_axe_infantry	commander
ksl_boyar_bodyguard2	wh3_ksl_pistol_great_weapon_infantry	commander
ksl_boyar_bodyguard3	wh2_dlc14_skv_infantry_guandao	commander
ksl_boyar_bodyguard4	wh2_dlc09_tmb_dual_sword	commander
ksl_boyar_bodyguard5	missile_cavalry_axe	commander
ksl_boyar_bodyguard6	wh3_ksl_elemental_bear	commander
ksl_boyar_bodyguard7	wh3_ksl_streltsi	commander
ksl_boyar_mount1	wh3_main_ksl_sled_rifle	commander
ksl_boyar_mount2	cannon	commander
ksl_druzhina_bodyguard1	missile_infantry_bow	commander
ksl_druzhina_bodyguard2	wh3_ksl_streltsi	commander
ksl_frost_maiden_ice_bodyguard1	wh3_main_lore_ice	heroes_agents
ksl_frost_maiden_ice_bodyguard2	wh3_main_lore_ice	heroes_agents
ksl_frost_maiden_tempest_bodyguard1	wh3_main_lore_tempest	heroes_agents
ksl_frost_maiden_tempest_bodyguard2	wh3_main_lore_tempest	heroes_agents
ksl_ice_guard_bodyguard1_lord	wh3_ksl_bow_glaive_infantry	commander
ksl_ice_guard_bodyguard2_lord	wh3_ksl_bow_dual_swords_infantry	commander
lzd_kroxigor_ancient_bodyguard_1	monstrous_infantry	commander
lzd_kroxigor_ancient_bodyguard_2	monstrous_infantry	commander
lzd_saurus_old_blood_bodyguard_1	wh2_main_lzd_infantry_mace	commander
lzd_saurus_old_blood_bodyguard_2	infantry_spear	commander
lzd_saurus_old_blood_bodyguard_3	wh2_main_cold_one	commander
lzd_saurus_old_blood_bodyguard_4	wh2_main_lzd_infantry_halberd	commander
lzd_saurus_old_blood_bodyguard_5	wh2_dlc17_lzd_horned_ones	commander
lzd_saurus_scar_veteran_bodyguard_1	wh2_main_lzd_champion	heroes_agents
lzd_saurus_scar_veteran_bodyguard_2	wh2_main_lzd_champion	heroes_agents
lzd_saurus_scar_veteran_bodyguard_3	wh2_main_lzd_champion	heroes_agents
lzd_saurus_scar_veteran_bodyguard_4	wh2_main_lzd_champion	heroes_agents
lzd_saurus_scar_veteran_bodyguard_5	wh2_main_lzd_champion	heroes_agents
lzd_skink_chief_bodyguard_1	wh2_main_lzd_spy	heroes_agents
lzd_skink_chief_bodyguard_2	wh2_main_lzd_spy	heroes_agents
lzd_skink_chief_bodyguard_3	wh2_main_lzd_spy	heroes_agents
lzd_skink_chief_bodyguard_4	wh2_main_lzd_spy	heroes_agents
lzd_skink_chief_red_crested_bodyguard_1	infantry_axe_great	commander
lzd_skink_chief_red_crested_bodyguard_2	wh2_dlc17_lzd_horned_ones	commander
lzd_skink_chief_red_crested_bodyguard_3	wh2_dlc17_lzd_ripperdactyl_riders	commander
lzd_skink_priest_beasts_bodyguard_1	wh_dlc03_lore_beasts	heroes_agents
lzd_skink_priest_beasts_bodyguard_2	wh_dlc03_lore_beasts	heroes_agents
lzd_skink_priest_heavens_bodyguard_1	wh_main_lore_heavens	heroes_agents
lzd_skink_priest_heavens_bodyguard_2	wh_main_lore_heavens	heroes_agents
master_assassin_bodyguard1	wh2_main_skv_missile_infantry_throwing_star	commander
master_assassin_bodyguard2	wh2_main_missile_infantry_sling	commander
master_assassin_bodyguard3	wh2_main_skv_spy	commander
plague_priest_bodyguard1	wh2_main_infantry_dual_swords	heroes_agents
plague_priest_bodyguard2	wh2_main_skv_infantry_censer	heroes_agents
plague_priest_bodyguard3	infantry_spear	heroes_agents
queek_headtaker_bodyguard1	infantry_cudgel	commander
queek_headtaker_bodyguard2	wh_dlc04_flagellant	commander
queek_headtaker_bodyguard3	infantry_spear_halberd	commander
skrolk_bodyguard1	wh2_main_infantry_dual_swords	commander
skrolk_bodyguard2	wh2_main_skv_infantry_censer	commander
skrolk_bodyguard3	infantry_spear	commander
skrolk_bodyguard4	wh2_main_lore_plague	commander
snikch_bodyguard1	wh2_main_skv_spy	commander
tcg_kho_bloodreaper_bodyguard_1	wh3_main_kho_bloodreaper	heroes_agents
tcg_kho_bloodreaper_bodyguard_2	wh3_main_kho_bloodreaper	heroes_agents
tcg_kho_bloodreaper_bodyguard_3	wh3_main_kho_bloodreaper	heroes_agents
tcg_kho_herald_of_khorne_bodyguard_1	wh3_main_kho_bloodreaper	commander
tcg_kho_herald_of_khorne_bodyguard_2	wh3_main_kho_bloodreaper	commander
tcg_kho_herald_of_khorne_bodyguard_3	wh3_main_kho_bloodreaper	commander
tcg_nur_herald_of_nurgle_death_bodyguard_1	wh_main_lore_death	commander
tcg_nur_herald_of_nurgle_death_bodyguard_2	wh_main_lore_death	commander
tcg_nur_herald_of_nurgle_death_bodyguard_3	wh_main_lore_death	commander
tcg_nur_herald_of_nurgle_nurgle_bodyguard_1	wh3_main_lore_nurgle	commander
tcg_nur_herald_of_nurgle_nurgle_bodyguard_2	wh3_main_lore_nurgle	commander
tcg_nur_herald_of_nurgle_nurgle_bodyguard_3	wh3_main_lore_nurgle	commander
tcg_nur_plagueridden_death_bodyguard_1	wh_main_lore_death	heroes_agents
tcg_nur_plagueridden_death_bodyguard_2	wh_main_lore_death	heroes_agents
tcg_nur_plagueridden_death_bodyguard_3	wh_main_lore_death	heroes_agents
tcg_nur_plagueridden_nurgle_bodyguard_1	wh3_main_lore_nurgle	heroes_agents
tcg_nur_plagueridden_nurgle_bodyguard_2	wh3_main_lore_nurgle	heroes_agents
tcg_nur_plagueridden_nurgle_bodyguard_3	wh3_main_lore_nurgle	heroes_agents
tcg_sla_alluress_shadow_bodyguard_1	wh_dlc05_wef_lore_shadow	heroes_agents
tcg_sla_alluress_shadow_bodyguard_2	wh_dlc05_wef_lore_shadow	heroes_agents
tcg_sla_alluress_shadow_bodyguard_3	wh_dlc05_wef_lore_shadow	heroes_agents
tcg_sla_alluress_slaanesh_bodyguard_1	wh3_main_lore_slaanesh	heroes_agents
tcg_sla_alluress_slaanesh_bodyguard_2	wh3_main_lore_slaanesh	heroes_agents
tcg_sla_alluress_slaanesh_bodyguard_3	wh3_main_lore_slaanesh	heroes_agents
tcg_sla_herald_of_slaanesh_shadow_bodyguard_1	wh_dlc05_wef_lore_shadow	commander
tcg_sla_herald_of_slaanesh_shadow_bodyguard_2	wh_dlc05_wef_lore_shadow	commander
tcg_sla_herald_of_slaanesh_shadow_bodyguard_3	wh_dlc05_wef_lore_shadow	commander
tcg_sla_herald_of_slaanesh_slaanesh_bodyguard_1	wh3_main_lore_slaanesh	commander
tcg_sla_herald_of_slaanesh_slaanesh_bodyguard_2	wh3_main_lore_slaanesh	commander
tcg_sla_herald_of_slaanesh_slaanesh_bodyguard_3	wh3_main_lore_slaanesh	commander
tcg_tze_herald_of_tzeentch_metal_bodyguard_1	wh_main_lore_metal	commander
tcg_tze_herald_of_tzeentch_metal_bodyguard_2	wh_main_lore_metal	commander
tcg_tze_herald_of_tzeentch_metal_bodyguard_3	wh_main_lore_metal	commander
tcg_tze_herald_of_tzeentch_tzeentch_bodyguard_1	wh3_main_lore_tzeentch	commander
tcg_tze_herald_of_tzeentch_tzeentch_bodyguard_2	wh3_main_lore_tzeentch	commander
tcg_tze_herald_of_tzeentch_tzeentch_bodyguard_3	wh3_main_lore_tzeentch	commander
tcg_tze_iridescent_horror_metal_bodyguard_1	wh_main_lore_metal	heroes_agents
tcg_tze_iridescent_horror_metal_bodyguard_2	wh_main_lore_metal	heroes_agents
tcg_tze_iridescent_horror_metal_bodyguard_3	wh_main_lore_metal	heroes_agents
tcg_tze_iridescent_horror_tzeentch_bodyguard_1	wh3_main_lore_tzeentch	heroes_agents
tcg_tze_iridescent_horror_tzeentch_bodyguard_2	wh3_main_lore_tzeentch	heroes_agents
tcg_tze_iridescent_horror_tzeentch_bodyguard_3	wh3_main_lore_tzeentch	heroes_agents
tmb_necrotect_mount1	wh2_dlc09_tmb_khemrian_warsphinx_missile	heroes_agents
tmb_necrotect_shape1	wh2_dlc09_tmb_scorpion	heroes_agents
tmb_necrotect_shape2	wh3_dlc26_tmb_giant	heroes_agents
tmb_necrotect_shape3	wh2_dlc09_tmb_hierotitan_magic_scales	heroes_agents
tmb_necrotect_shape4	wh2_dlc09_tmb_necrosphinx	heroes_agents
tmb_tomb_king_bodyguard1	infantry_sword	commander
tmb_tomb_king_bodyguard2	infantry_spear_halberd	commander
tmb_tomb_king_bodyguard3	wh2_dlc09_tmb_cavalry_sword	commander
tmb_tomb_prince_bodyguard1	wh2_dlc09_tmb_dual_sword	heroes_agents
tmb_tomb_prince_bodyguard2	infantry_spear_halberd	heroes_agents
tmb_tomb_prince_bodyguard3	wh2_dlc09_tmb_cavalry_spear	heroes_agents
tmb_tomb_prince_bodyguard4	wh2_dlc09_tmb_necroserpent_halberd	heroes_agents
tmb_tomb_prince_mount1	wh2_dlc09_tmb_khemrian_warsphinx_missile	heroes_agents
tmb_tomb_prince_mount2	wh2_dlc09_tmb_tomb_prince	heroes_agents
tretch_craventail_bodyguard1	wh2_main_skv_infantry_sword_stormvermin	commander
tretch_craventail_bodyguard2	wh2_main_skv_infantry_halberd	commander
warlock_engineer_bodyguard1	wh2_dlc11_cst_specialist_missile_infantry	heroes_agents
warlock_engineer_bodyguard2	wh2_dlc11_cst_specialist_missile_infantry	heroes_agents
warlock_engineer_bodyguard3	dwf_irondrakes	heroes_agents
warlock_engineer_bodyguard4	wh2_dlc14_skv_warp_grinder	heroes_agents
warlock_engineer_bodyguard5	wh2_dlc14_skv_missile_infantry_poisoned_wind_mortar	heroes_agents
warlock_engineer_bodyguard6	wh2_main_skv_missile_infantry_globe	heroes_agents
warlock_master_bodyguard1	wh2_dlc11_cst_specialist_missile_infantry	commander
warlock_master_bodyguard2	wh2_dlc11_cst_specialist_missile_infantry	commander
warlock_master_bodyguard3	dwf_irondrakes	commander
warlock_master_bodyguard4	wh2_dlc14_skv_warp_grinder	commander
warlock_master_bodyguard5	wh2_dlc14_skv_missile_infantry_death_globe_mortar	commander
warlock_master_bodyguard6	wh2_main_skv_missile_infantry_globe_death	commander
warlock_master_bodyguard7	wh2_main_lore_ruin	commander
warlock_master_bodyguard8	wh2_main_lore_ruin	commander
warlord_bodyguard1	infantry_sword	commander
warlord_bodyguard2	infantry_spear	commander
warlord_bodyguard3	wh2_main_skv_infantry_sword_stormvermin	commander
warlord_bodyguard4	wh2_main_skv_infantry_halberd	commander
warlord_bodyguard5	wh2_dlc16_skv_chieftain	commander
warlord_bodyguard6	wh2_dlc16_skv_brood_horror	commander
wef_female_glade_lord_bodyguard_1	infantry_spear	commander
wef_female_glade_lord_bodyguard_2	wh2_dlc10_hef_handmaiden	commander
wef_female_glade_lord_bodyguard_3	missile_cavalry_bow	commander
wef_female_glade_lord_bodyguard_4	wh_dlc05_wef_sisters_thorn	commander
wef_female_glade_lord_bodyguard_5	wh_dlc05_wef_wild_riders	commander
wef_glade_captain_bodyguard_1	wh2_dlc10_hef_handmaiden	heroes_agents
wef_glade_captain_bodyguard_2	missile_cavalry_bow	heroes_agents
wef_glade_captain_bodyguard_3	infantry_sword_great	heroes_agents
wef_glade_captain_bodyguard_4	wh2_main_infantry_dual_swords	heroes_agents
wef_glade_captain_bodyguard_5	wh_dlc05_wef_sisters_thorn	heroes_agents
wef_glade_captain_bodyguard_6	wh_dlc05_wef_wild_riders	heroes_agents
wef_glade_lord_bodyguard_1	infantry_spear	commander
wef_glade_lord_bodyguard_2	missile_infantry_bow	commander
wef_glade_lord_bodyguard_3	wh_dlc05_wef_wild_riders	commander
wef_glade_lord_bodyguard_4	wh_dlc05_wef_hawk_riders	commander
wef_glade_lord_bodyguard_5	wh_dlc05_wef_wild_riders	commander
wef_waystalker_bodyguard_1	wh_dlc05_wef_waystalker	heroes_agents
wef_waystalker_bodyguard_2	missile_cavalry_bow	heroes_agents
wef_waystalker_bodyguard_3	wh3_dlc23_ksl_ulrika	heroes_agents
wef_waystalker_bodyguard_4	wh_dlc05_wef_hawk_riders	heroes_agents
